##########
#........#
#........#
D......%.#
#........#
#........#
##########