#####D####
#........#
#........#
#........D
#..###...#
#........#
####D#####