#####D####
##......##
#..#.....#
#@@#.....D
######...#
#@@@...@@#
####D#####