####D#####
#@@#.....#
#@@#.....#
#........D
#..###...#
#@.....@@#
##########