##########
#........#
#........#
D........D
#........#
#........#
##########