####D#####
#........#
#........#
D........#
#........#
#........#
##########