##########
#@@@@@@@!#
#........#
D........D
#........#
#@@@@@@@!#
##########