##########
###@@@@@@#
##@@.....#
#@@......D
#@.......#
#@.......#
#####D####