#####D####
#........#
#........#
#........D
#..###...#
#......@@#
####D#####