####D#####
#........#
#........#
#........D
#..###...#
#........#
##########