##########
##########
#.@@..@@.#
D........D
#@..@@..@#
##########
##########