##########
#@@@@@@@@#
#@......@#
D...##...D
#..#.....#
#..#.....#
####D#####