##########
#........#
#........#
D........D
#........#
#.!......#
##########