##########
#....@@@@#
#....@@@@#
D....@@@@#
#....@@@@#
#....@@@@#
##########