##########
#........#
#........#
D........#
#........#
#.!......#
##########