####D#####
@@@!.....#
#........#
D........#
#........#
@@@@@@@@!#
##########