##########
#........#
#........#
D........#
#........#
#.......!#
##########